WWWWWWWWWWWW   W W   WWWWWWWWWW
W    WW    W   W W   W        W
W WW WW WW W   W W   W WW WWW W
W WW    WW W   W W   W WW WWW W
W WW WWWWW W   W W   W WW WWW W
W WW WWWWW WWWWW WWWWW WW WWW W
W WW                          W
W WWWWW WW WWWWW WWWWWWWW WWW W
W WWWWW WW WWWWW WWWWWWWW WWW W
W WW    WW          WW    WWW W
W WW WW WW WW HHHHH WW WW WWW W
W WW WW WW WW HHHHH WW WW WWW W
W    WW    WW HHHHH    WW     W
W WWWWW WWWWW HHHHD WWWWW WWWWW
W WWWWW WWWWW HHHHD WWWWW WWWWW
W    WW    WW HHHHH    WW     W
W WW WW WW WW HHHHH WW WW WWW W
W WW WW WW WW HHHHH WW WW WWW W
W WW    WW          WW    WWW W
W WWWWW WW WWWWW WWWWWWWW WWW W
W WWWWW WW WWWWW WWWWWWWW WWW W
W WW                          W
W WW WWWWW WWWWW WWWWW WW WWW W
W WW WWWWW W   W W   W WW WWW W
W WW    WW W   W W   W WW WWW W
W WW WW WW W   W W   W WW WWW W
W    WW    W   W W   W        W
WWWWWWWWWWWW   W W   WWWWWWWWWW
